1200 750
10 10 110 50
530 530 140 20
530 520 6 -2 -2
1 1 1 1 1 1 1 1 1 1
1 1 1 8 1 1 1 1 1 1
1 0 0 0 0 0 0 0 0 0
1 1 1 1 1 0 0 0 0 0
0 0 0 0 0 0 0 0 0 0
0 0 0 0 0 0 0 0 0 0
0 0 0 0 0 0 0 0 0 0
0 0 0 0 0 0 0 0 0 0
0 0 0 0 0 0 0 0 0 0
0 0 0 0 0 0 0 0 0 0