20 20 1 1
6 19 6 1
7 4 1 -1 1
0 0 0 0 0 0 0 0 0 0 0 0 0 0 0 0 0 0 0 0 
0 8 8 8 8 8 8 8 8 8 8 0 0 0 0 0 0 0 0 0 
0 8 0 8 0 0 0 0 0 0 8 0 0 0 0 0 0 0 0 0 
0 8 0 8 0 0 0 0 0 0 8 0 0 0 0 0 0 0 0 0 
0 8 0 8 0 0 0 0 0 0 8 0 0 0 0 0 0 0 0 0 
0 8 0 8 0 0 0 0 0 0 8 0 0 0 0 0 0 0 0 0 
0 8 0 8 0 0 0 0 0 0 8 0 0 0 0 0 0 0 0 0 
0 8 0 8 0 0 0 0 0 0 8 0 0 0 0 0 0 0 0 0 
0 8 8 8 8 8 8 8 8 8 8 0 0 0 0 0 0 0 0 0 
0 0 0 0 0 0 0 0 0 0 0 0 0 0 0 0 0 0 0 0 
0 0 0 0 0 0 0 0 0 0 0 0 0 0 0 0 0 0 0 0 
0 0 0 0 0 0 0 0 0 0 0 0 0 0 0 0 0 0 0 0 
0 0 0 0 0 0 0 0 0 0 0 0 0 0 0 0 0 0 0 0 
0 0 0 0 0 0 0 0 0 0 0 0 0 0 0 0 0 0 0 0 
0 0 0 0 0 0 0 0 0 0 0 0 0 0 0 0 0 0 0 0 
0 0 0 0 0 0 0 0 0 0 0 0 0 0 0 0 0 0 0 0 
0 0 0 0 0 0 0 0 0 0 0 0 0 0 0 0 0 0 0 0 
0 0 0 0 0 0 0 0 0 0 0 0 0 0 0 0 0 0 0 0 
0 0 0 0 0 0 0 0 0 0 0 0 0 0 0 0 0 0 0 0 
