1200 800
10 10 110 50
530 530 140 20
700 200 6 -1 7 7
1 1 1 1 1 1 1 1 1 1
0 0 0 8 1 1 1 1 1 1
1 1 0 0 0 0 0 1 1 1
1 1 0 0 0 0 0 1 1 1
0 0 0 0 0 0 0 0 0 0
0 0 0 0 0 0 0 0 0 0
0 0 0 0 0 0 0 0 0 0
0 0 0 0 0 0 0 0 0 0
0 0 0 0 0 0 0 0 0 0
0 0 0 0 0 0 0 0 0 0
0 0 0 0 0 0 0 0 0 0
0 0 0 0 0 0 0 0 0 0