1200 750
10 10 110 50
530 530 140 20
450 400 10 0 -10
1 2 3 8 8 1 1 1 1 1
1 2 3 8 8 1 1 1 1 1
1 2 0 8 8 1 1 1 1 1
1 2 0 0 8 1 1 1 1 1
0 0 0 0 0 0 0 0 0 0
0 0 0 0 0 0 0 0 0 0
0 0 0 0 0 0 0 0 0 0
0 0 0 0 0 0 0 0 0 0
0 0 0 0 0 0 0 0 0 0
0 0 0 0 0 0 0 0 0 0