1200 800
15 11 100 40
530 600 90 20
600 585 6 -1 -6 6
2 2 2 2 4 0 4 2 2 2 2
1 1 1 4 0 4 0 4 1 1 1
2 2 4 0 4 2 4 0 4 2 2
1 4 0 4 1 1 1 4 0 4 1
2 2 4 0 4 2 4 0 4 2 2
1 1 1 4 0 4 0 4 1 1 1
2 2 2 2 4 0 4 2 2 2 2
0 0 0 0 0 0 0 0 0 0 0
0 0 0 0 0 0 0 0 0 0 0
0 0 0 0 0 0 0 0 0 0 0
0 0 0 0 0 0 0 0 0 0 0
0 0 0 0 0 0 0 0 0 0 0
0 0 0 0 0 0 0 0 0 0 0
0 0 0 0 0 0 0 0 0 0 0
0 0 0 0 0 0 0 0 0 0 0
