20 48 4 2
16 19 6 1
9 4 1 -1 1
8 8 8 8 8 8 8 8 8 8 8 8
8 0 0 0 0 3 0 0 0 0 0 8
8 0 0 0 0 0 0 0 0 0 0 8
8 0 3 0 3 0 0 3 0 3 0 8
8 0 0 0 0 0 0 0 0 0 0 8
8 0 0 0 0 0 0 0 0 0 0 8
8 0 0 0 0 0 0 0 0 0 0 8
8 8 8 8 8 8 8 8 8 8 8 8
0 0 0 0 0 0 0 0 0 0 0 0
0 0 0 0 0 0 0 0 0 0 0 0
