20 20 1 1 7 19 6 1 6 18 0
0 0 0 0 0 0 0 0 0 0 0 0 0 0 0 0 0 0 0 0 
0 0 0 0 0 0 0 0 0 0 0 0 0 0 0 0 0 0 0 0 
1 1 0 0 0 1 1 1 0 0 0 0 1 1 1 0 0 0 1 1 
1 1 0 0 0 1 1 1 0 0 0 0 1 1 1 0 0 0 1 1 
1 1 0 0 0 1 1 1 0 0 0 0 1 1 1 0 0 0 1 1 
1 1 0 0 0 1 1 1 0 0 0 0 1 1 1 0 0 0 1 1 
1 1 0 0 0 1 1 1 0 0 0 0 1 1 1 0 0 0 1 1 
1 1 0 0 0 1 1 1 0 0 0 0 1 1 1 0 0 0 1 1 
1 1 0 0 0 1 1 1 0 0 0 0 1 1 1 0 0 0 1 1 
0 0 0 0 0 0 8 0 0 0 0 0 0 8 0 0 0 0 0 0
0 0 0 0 0 0 0 0 0 0 0 0 0 0 0 0 0 0 0 0 
0 0 0 0 0 0 0 0 0 0 0 0 0 0 0 0 0 0 0 0 
0 0 0 0 0 0 0 0 0 0 0 0 0 0 0 0 0 0 0 0 
0 0 0 0 0 0 0 0 0 0 0 0 0 0 0 0 0 0 0 0 
0 0 0 0 0 0 0 0 0 0 0 0 0 0 0 0 0 0 0 0 
0 0 0 0 0 0 0 0 0 0 0 0 0 0 0 0 0 0 0 0 
0 0 0 0 0 0 0 0 0 0 0 0 0 0 0 0 0 0 0 0 
0 0 0 0 0 0 0 0 0 0 0 0 0 0 0 0 0 0 0 0 
0 0 0 0 0 0 0 0 0 0 0 0 0 0 0 0 0 0 0 0 
