1200 800
15 11 100 40
530 600 140 20
600 585 6 -1 -4 4
0 0 0 0 0 0 0 0 0 0 0
0 8 0 1 3 1 3 1 0 8 0
0 8 0 1 2 1 2 1 0 8 0
0 3 0 1 1 1 1 1 0 3 0
0 3 0 1 2 1 2 1 0 3 0
0 2 0 1 3 1 3 1 0 2 0
0 1 0 1 2 3 2 1 0 1 0
0 8 0 0 0 0 0 0 0 8 0
0 0 0 0 0 0 0 0 0 0 0
0 0 0 0 0 0 0 0 0 0 0
0 0 0 0 0 0 0 0 0 0 0
0 0 0 0 0 0 0 0 0 0 0
0 0 0 0 0 0 0 0 0 0 0
0 0 0 0 0 0 0 0 0 0 0
0 0 0 0 0 0 0 0 0 0 0





