20 80 4 1
16 19 6 1
40 18 1 -1 -1
0 0 0 0 0 0 0 0 0 0 0 0 0 0 0 0 0 0 0 0
0 0 0 0 0 0 0 0 0 0 0 0 0 0 0 0 0 0 0 0
0 1 1 1 0 1 0 0 1 0 1 0 0 1 0 1 1 1 0 0
0 1 0 0 0 1 0 0 1 0 1 0 0 1 0 1 0 0 1 0
0 1 0 0 0 1 0 0 1 0 1 0 0 1 0 1 0 0 1 0
0 1 0 0 0 1 1 1 1 0 1 0 0 1 0 1 1 1 0 0
0 1 0 0 0 1 1 1 1 0 1 0 0 1 0 1 1 1 0 0
0 1 0 0 0 1 0 0 1 0 1 0 0 1 0 1 0 0 1 0
0 1 0 0 0 1 0 0 1 0 1 0 0 1 0 1 0 0 1 0
0 1 1 1 0 1 0 0 1 0 1 1 1 1 0 1 1 1 0 0
0 0 0 0 0 0 0 0 0 0 0 0 0 0 0 0 0 0 0 0
0 0 0 0 0 0 0 0 0 0 0 0 0 0 0 0 0 0 0 0
0 0 0 0 0 0 0 0 0 0 0 0 0 0 0 0 0 0 0 0
0 0 0 0 0 0 0 0 0 0 0 0 0 0 0 0 0 0 0 0
0 0 0 0 0 0 0 0 0 0 0 0 0 0 0 0 0 0 0 0
0 0 0 0 0 0 0 0 0 0 0 0 0 0 0 0 0 0 0 0
0 0 0 0 0 0 0 0 0 0 0 0 0 0 0 0 0 0 0 0
0 0 0 0 0 0 0 0 0 0 0 0 0 0 0 0 0 0 0 0
0 0 0 0 0 0 0 0 0 0 0 0 0 0 0 0 0 0 0 0
0 0 0 0 0 0 0 0 0 0 0 0 0 0 0 0 0 0 0 0