1200 800
10 10 110 50
530 530 140 20
530 500 6 -5 -1 5
0 0 8 0 0 0 0 8 0 0
0 3 3 3 3 3 3 3 3 0
0 2 2 2 2 2 2 2 2 0
0 0 0 0 0 0 0 0 0 0
0 2 2 2 2 2 2 2 2 0
0 3 3 3 3 3 3 3 3 0
0 0 8 0 0 0 0 8 0 0
0 0 0 0 0 0 0 0 0 0
0 0 0 0 0 0 0 0 0 0
0 0 0 0 0 0 0 0 0 0