1200 800
15 11 100 40
530 600 140 20
600 585 6 -4 -1 4
0 0 8 0 0 0 0 0 8 0 0
0 0 0 0 0 0 0 0 0 0 0
0 3 3 3 3 3 3 3 3 3 0
0 2 2 2 2 2 2 2 2 2 0
0 0 0 0 0 8 0 0 0 0 0
0 2 2 2 2 2 2 2 2 2 0
0 3 3 3 3 3 3 3 3 3 0
0 0 8 0 0 0 0 0 8 0 0
0 0 0 0 0 0 0 0 0 0 0
0 0 0 0 0 0 0 0 0 0 0
0 0 0 0 0 0 0 0 0 0 0
0 0 0 0 0 0 0 0 0 0 0
0 0 0 0 0 0 0 0 0 0 0
0 0 0 0 0 0 0 0 0 0 0
0 0 0 0 0 0 0 0 0 0 0