1200 800
15 11 100 40
530 600 140 20
600 585 6 -1 -6 6
0 4 0 0 0 0 0 0 0 4 0
8 8 8 8 4 0 4 8 8 8 8
0 0 0 0 0 0 0 0 0 0 0
0 4 2 3 0 1 0 3 2 4 0
0 4 2 3 0 1 0 3 2 4 0
0 4 2 3 0 1 0 3 2 4 0
0 4 2 3 0 1 0 3 2 4 0
0 0 0 0 0 0 0 0 0 0 0
8 8 8 0 0 0 0 0 8 8 8
0 0 0 0 0 0 0 0 0 0 0
0 0 0 0 0 0 0 0 0 0 0
0 0 0 0 0 0 0 0 0 0 0
0 0 0 0 0 0 0 0 0 0 0
0 0 0 0 0 0 0 0 0 0 0
0 0 0 0 0 0 0 0 0 0 0

