1200 800
10 10 110 50
530 530 140 20
530 500 6 -5 -1 5
0 1 1 1 1 1 1 1 1 0
8 0 8 0 8 0 8 0 8 0
0 1 0 2 0 3 0 2 0 1
3 0 2 0 1 0 3 0 2 0
1 0 2 0 3 0 2 0 1 0
8 0 8 0 8 0 8 0 8 0
0 0 0 0 0 0 0 0 0 0
0 0 0 0 0 0 0 0 0 0
0 0 0 0 0 0 0 0 0 0
0 0 0 0 0 0 0 0 0 0

