1200 800
15 11 100 40
530 600 140 20
600 585 6 -1 -4 4
0 0 4 4 0 0 0 4 4 0 0
0 4 1 1 4 0 4 1 1 4 0
4 1 2 0 1 1 1 2 2 1 4
4 1 0 3 2 2 2 3 2 1 4
4 1 2 3 3 3 3 3 2 1 4
0 4 1 2 3 3 3 2 1 4 0
0 0 4 1 2 3 2 1 4 0 0
0 0 0 4 1 2 1 4 0 0 0
0 0 0 0 4 1 4 0 0 0 0
0 0 0 0 0 4 0 0 0 0 0
0 0 0 0 0 0 0 0 0 0 0
0 0 0 0 0 0 0 0 0 0 0
0 0 0 0 0 0 0 0 0 0 0
0 0 0 0 0 0 0 0 0 0 0
0 0 0 0 0 0 0 0 0 0 0