1200 800
10 10 110 50
530 600 140 20
600 585 6 -1 -4 4	
1 1 1 1 1 1 1 1 1 1 1
1 1 1 1 1 1 1 1 1 1 1
1 1 1 1 1 1 1 1 1 1 1
1 1 1 1 1 1 1 1 1 1 1
1 1 1 1 0 0 0 1 1 1 1
1 1 1 8 0 0 0 8 1 1 1
1 1 8 0 0 0 0 0 8 1 1
1 8 0 0 0 0 0 0 0 8 1
0 0 0 0 0 0 0 0 0 0 0
0 0 0 0 0 0 0 0 0 0 0
0 0 0 0 0 0 0 0 0 0 0
0 0 0 0 0 0 0 0 0 0 0
0 0 0 0 0 0 0 0 0 0 0
0 0 0 0 0 0 0 0 0 0 0
0 0 0 0 0 0 0 0 0 0 0